222222222222222222222222222222222222222222222222222222222222222222222
200000000000000000000000000000000000000000000000000000000000000000002
200000000000000000000000000000001111111111111000000000000000000000002
200000000111111000000000000000001000000000001000000000000000000000002
200000000100001000000111111111111000000000001111100000000000000000002
200000000100001100000100000000001000000000001000100000000000000000002
200000000100000100000100000000000000000000000000100000000000000000002
200000000100000100000100000000001000000000001000100000000000000000002
200000000111110111110100011111111000000000001111100000000000000000002
200000000100000000010100010000001000000000001000000000000000000000002
200000000100000000011100011100001111110111111000000000000000000000002
200000000100000000010000000100000000100010000000000000000000000000002
200000000100000000000000000100000000100010000000000000000000000000002
200000000100000000010000000100000000100010000000000000000000000000002
200011111100000000011111111100000000100010000000000000000000000000002
200010001100000000010000000000000000100010000000000000000000000000002
200010001111110111110000000000011111100011100000000000000000000000002
200010001111100010000000000000010000000000100000000000000000000000002
200111011111100010000000000000010011100011100000000000000000000000002
200100001111100010000000000000010010100010000000000000000000000000002
200100001000100010000000000000010010100010000000000000000000000000002
200100000000100010000000000000011110100010000000000000000000000000002
200100001000100010000000000000000000100010000000000000000000000000002
200100001111110111110000000000000001110111000000000000000111111111102
200100001100000000010000000000111111000001111110000000000100000000102
200100001100000000010000000000100000000000000010000000000100000000102
200100001100000000010000000000100000000000000011111111111100000000102
200100000100000000010000000000100000000000000001000000000100000000102
200100000000000000010000000000100000000000000000000000000000000000102
200100000100000000010000000000100000000000000001000000000100000000102
200100001100000000010000000000100000000000000011110000111100000000102
200100001100000000010000000000100000000000000010011001100100000000102
200100001100000000010000000000111111000001111110001001000100000000102
200100001111110111110000000000000001110111000000001001000111111111102
200100001111100010000000000000000000100010000000001001000000000000002
200100001111100010000000000000000000100010000000001001000000000000002
200100001000100010000000000000000000100010000000001001011111111100002
200100000000100010000000000000000000100010000000001001110101010110002
200100001000100010000000000000000000100010000000001000100000000010002
200100001111100010000000000000000000100010000000001000000000000010002
200100001111100011111111111111000000100010000000001000100000000010002
200100000000000000000100000001100000100010000000001111110101010110002
200100000000000000000000000000110000100010000000000000011111111100002
200100000000000000000100000001100000100010000000000000000000000000002
200111111111111111111101111111000000100010000000000000000000000000002
200000000000110100100000100000011111110111111100000000000000000000002
20000000000010e000100101100000010000100010000100000000000000000000002
200000000000110100000111000000010000000000000100000000000000000000002
200000000000011110111100000000010000100010000100000000000000000000002
200000000000000010010000000000010000100010000100000000000000000000002
200000000000000010010000000000011111100011111100000000000000000000002
200000000000000011110000000000010000100010000100000000000000000000002
200000000000000000000000000000010s00000000000100000000000000000000002
200000000000000000000000000000010000100010000100000000000000000000002
200000000000000000000000000000011111100011111100000000000000000000002
200000000000000000000000000000010000000000000100000000000000000000002
200000000000000000000000000000010000000000000100000000000000000000002
200000000000000000000000000000010000000000000100000000000000000000002
200000000000000000000000000000011111111111111100000000000000000000002
200000000000000000000000000000000000000000000000000000000000000000002
222222222222222222222222222222222222222222222222222222222222222222222